0 7 15
+------ ------+
|t     s      |
|             |
              |
|             |
|   t  s      |
+-------------+