0 7 15
+------ ------+
|t     s      |
|C            |
              |
|E  t         |
|   t  s      |
+-------------+
4 7 15
+-------------+
|             |
|      BBBBBB||
       B Bed ||
|      BBBBBB||
|             |
+-------------+
5 7 15
+-----| |-----+      
|     | |     |
======+ +======
               
======+ +======
|     | |     |
+-----| |-----+