8 8
o o o o o o k o
o o o o o o o o
o o o k o o o o
o o o o o o o k
o o o o o o o o
o o o o o o o o
o o o o d o o o
o o o o o o o o